000000000000000000000000000000000000000000000000000000000000000000000000000000000000000000000000000000000000000000000000
011111111111111111111111111111111111111111111111111111111111111111111111111111111111111111111111111111111111111111111110
010010010000001000100000100000001000000001000000000000000000000000000000000000000000000000000000000000000000001000000010
010000000000001000001110111100001000000001000000000000000000000000000000000000000000000000000000000000000000011000000010
011111110000000000001000000100001000000001000000000000011111111111111111111111111110000000000000000000000000110000000010
010010000001111111111111110100000011111111000000000000000000000000000100000000000000000000000000000000000001100000001110
010000000000010000000100010000011110000001000000000000000000000000000100000000000000000000000000000000000011000000011010
010000000000010000000100010000000000000000000000000000000000000000000100000000000000000000000000000000000110000000110010
011111111100011111000000000000011110000001000000000000000000000000000100000000000000000000000000000000001100000001100010
010010000000010000010000010000000011111111000000000000000000000000000000000000000000000000000000000000011000000011000010
010010000000010000110011110000001000000001000000000000000000000000000000000000000000000000000000000000110000000110000010
010010000000000000100000010000001000000001000000000000000000000000000000000000000000000000000000000001100000000100000010
010000000000010000100000010000001000000001000000000000000000000000000100000000000000000000000000000011000000000100000010
011111111111111111111111111111111111111111111111111111111000000000000100000000000000000000000000000110000000000000000010
010000100000000000000100000000100000001000000000000000000000000000000100000000000000000000000000001100000000000100000010
010000100000000000000100000000100000001000000000000000000000000000000100000000000000000000000000011000000000000100000010
010000100000011111111100000000111111001000000000000000000000000000000111111111111111111111000000110000000000000110000010
010000111111000000000100000000100000001000000000000000000000000000000100000000001000000000000001100000000000000010000010
010000100000000001111111111000000000001000000000110110011011011111111100000000001000000000000001000000000000000010000010
010000100000000001000000000000100000001000000000000000000000000000000100000000001000000000000000000000000000001111100010
010000100000000001000000000111111111111000000000100000000000000000000000000000001000000000000001000000000000001000100010
010000000000000001000000000000000000001000000000100000000000000000000000000000001000000000000001100000000000001000111010
010000111111111111000000000000000000001000000000000000000000000000000000000000001000000000000000110000000000000000001010
010000000010000001000000000000000000001000000000111111111000000000000100000000001111111111110000011000000000001000001010
010000000010000001000000000000000000001000000000000000001111111111111100000000001000000000000000001100000000001000001010
010000000010000001000000000000000000000000000000000000000000000000000100000000001000000000000000000110000000011111111010
010000000010000000000000000000000000000000000000000000000000000000000100000000000000000000000000000011000000000000001010
010000000000000000000000000000000000000000000000000000000000000000000100000000000000000000000000000001000000000000000010
011111111111111111111111111111111111111111111111111111111111111111111111111111111111111111111111111111111111111111111110
000000000000000000000000000000000000000000000000000000000000000000000000000000000000000000000000000000000000000000000000